Episode,Total Reward,Epsilon,Steps,Success,Exploration,Exploitation,Max Q-value
1,-284,1.0,300,0,300,0,7.5
2,-284,0.995,300,0,299,1,6.19455975703125
3,-284,0.990025,300,0,296,4,11.850799642499311
4,-284,0.985074875,300,0,291,9,10.694338084737367
5,-284,0.9801495006250001,300,0,293,7,12.188385122696815
6,-200,0.9752487531218751,277,1,274,3,30.0
7,-202,0.9703725093562657,279,1,272,7,45.0
8,-284,0.9655206468094844,300,0,288,12,45.0
9,-21,0.960693043575437,98,1,93,5,52.5
10,-284,0.9558895783575597,300,0,290,10,52.5
11,-692,0.9511101304657719,300,0,288,12,25.607076362437496
12,-284,0.946354579813443,300,0,286,14,25.607076362437496
13,-284,0.9416228069143757,300,0,277,23,28.320591937050153
14,-284,0.9369146928798039,300,0,279,21,32.76654701416027
15,-284,0.9322301194154049,300,0,278,22,29.83100581509224
16,-284,0.9275689688183278,300,0,282,18,36.10193451344
17,-284,0.9229311239742362,300,0,271,29,39.72410791208618
18,-102,0.918316468354365,179,1,163,16,39.93151688167397
19,-125,0.9137248860125932,202,1,178,24,45.62237831524658
20,-284,0.9091562615825302,300,0,275,25,45.62237831524658
21,-284,0.9046104802746175,300,0,271,29,45.62237831524658
22,-284,0.9000874278732445,300,0,266,34,45.62237831524658
23,-284,0.8955869907338783,300,0,269,31,45.62237831524658
24,-284,0.8911090557802088,300,0,266,34,45.62237831524658
25,-109,0.8866535105013078,186,1,166,20,52.81118915762329
26,-284,0.8822202429488013,300,0,258,42,52.81118915762329
27,-284,0.8778091417340573,300,0,268,32,52.81118915762329
28,-284,0.8734200960253871,300,0,264,36,52.81118915762329
29,-39,0.8690529955452602,116,1,99,17,56.405594578811645
30,-284,0.8647077305675338,300,0,266,34,56.405594578811645
31,-284,0.8603841919146962,300,0,265,35,56.405594578811645
32,-284,0.8560822709551227,300,0,255,45,56.405594578811645
33,-284,0.851801859600347,300,0,254,46,56.405594578811645
34,-284,0.8475428503023453,300,0,246,54,56.405594578811645
35,-20,0.8433051360508336,97,1,81,16,58.20279728940582
36,-284,0.8390886103705794,300,0,246,54,58.20279728940582
37,-284,0.8348931673187264,300,0,246,54,58.20279728940582
38,-284,0.8307187014821328,300,0,246,54,58.20279728940582
39,-284,0.8265651079747222,300,0,256,44,58.20279728940582
40,-284,0.8224322824348486,300,0,243,57,58.20279728940582
41,-210,0.8183201210226743,287,1,226,61,59.10139864470291
42,-37,0.8142285204175609,114,1,91,23,59.550699322351456
43,-284,0.810157377815473,300,0,239,61,59.550699322351456
44,-284,0.8061065909263957,300,0,244,56,59.550699322351456
45,-284,0.8020760579717637,300,0,238,62,59.550699322351456
46,-284,0.798065677681905,300,0,229,71,59.550699322351456
47,-154,0.7940753492934954,231,1,186,45,59.775349661175724
48,-284,0.7901049725470279,300,0,233,67,59.775349661175724
49,-452,0.7861544476842928,300,0,229,71,49.39265095827806
50,-11,0.7822236754458713,88,1,69,19,49.39265095827806
51,19,0.778312557068642,58,1,41,17,53.114042365648295
52,-284,0.7744209942832988,300,0,236,64,53.114042365648295
53,-51,0.7705488893118823,128,1,98,30,56.557021182824144
54,-734,0.7666961448653229,300,0,241,59,41.82832187252846
55,-83,0.7628626641409962,160,1,127,33,43.862547974659606
56,-134,0.7590483508202912,211,1,157,54,51.9312739873298
57,-284,0.7552531090661897,300,0,221,79,51.9312739873298
58,-158,0.7514768435208588,235,1,181,54,55.9656369936649
59,-7,0.7477194593032545,84,1,64,20,57.98281849683245
60,-284,0.7439808620067382,300,0,219,81,57.98281849683245
61,-87,0.7402609576967045,164,1,122,42,58.991409248416225
62,-64,0.736559652908221,141,1,101,40,59.495704624208116
63,-5,0.7328768546436799,82,1,62,20,59.74785231210406
64,37,0.7292124703704616,40,1,32,8,59.87392615605203
65,-284,0.7255664080186093,300,0,221,79,59.87392615605203
66,-146,0.7219385759785162,223,1,157,66,59.93696307802601
67,-78,0.7183288830986236,155,1,109,46,59.968481539013005
68,-123,0.7147372386831305,200,1,148,52,59.9842407695065
69,-81,0.7111635524897149,158,1,118,40,59.99212038475325
70,38,0.7076077347272662,39,1,26,13,59.996060192376625
71,-82,0.7040696960536299,159,1,102,57,59.998030096188316
72,13,0.7005493475733617,64,1,46,18,59.99901504809416
73,39,0.697046600835495,38,1,26,12,59.999507524047075
74,28,0.6935613678313175,49,1,36,13,59.99975376202354
75,35,0.6900935609921609,42,1,25,17,59.99987688101177
76,35,0.6866430931872001,42,1,31,11,59.999938440505886
77,-78,0.6832098777212641,155,1,99,56,59.99996922025294
78,-87,0.6797938283326578,164,1,121,43,59.999984610126475
79,-12,0.6763948591909945,89,1,58,31,59.99999230506324
80,49,0.6730128848950395,28,1,18,10,59.99999615253162
81,17,0.6696478204705644,60,1,43,17,59.99999807626581
82,23,0.6662995813682115,54,1,36,18,59.999999038132906
83,-85,0.6629680834613705,162,1,110,52,59.99999951906645
84,51,0.6596532430440636,26,1,15,11,59.999999759533225
85,45,0.6563549768288433,32,1,19,13,59.99999987976661
86,22,0.653073201944699,55,1,38,17,59.99999993988331
87,-101,0.6498078359349755,178,1,106,72,59.999999969941655
88,35,0.6465587967553006,42,1,25,17,59.99999998497083
89,29,0.6433260027715241,48,1,26,22,59.999999992485414
90,-23,0.6401093727576664,100,1,70,30,59.99999999624271
91,-86,0.6369088258938781,163,1,103,60,59.99999999812135
92,-34,0.6337242817644086,111,1,72,39,59.99999999906068
93,5,0.6305556603555866,72,1,45,27,59.99999999953034
94,0,0.6274028820538087,77,1,51,26,59.999999999765166
95,1,0.6242658676435396,76,1,45,31,59.99999999988258
96,28,0.6211445383053219,49,1,33,16,60.16480380538125
97,49,0.6180388156137953,28,1,15,13,63.8801048385037
98,30,0.6149486215357263,47,1,31,16,62.76109342396778
99,-284,0.6118738784280476,300,0,200,100,59.99999999998532
100,-76,0.6088145090359074,153,1,89,64,59.99999999999266
101,-57,0.6057704364907278,134,1,73,61,59.999999999996334
102,29,0.6027415843082742,48,1,30,18,59.99999999999817
103,-96,0.5997278763867329,173,1,106,67,59.99999999999908
104,-77,0.5967292370047992,154,1,90,64,59.999999999999545
105,-20,0.5937455908197752,97,1,54,43,59.99999999999977
106,-11,0.5907768628656763,88,1,45,43,59.999999999999886
107,12,0.5878229785513479,65,1,36,29,59.99999999999994
108,46,0.5848838636585911,31,1,22,9,59.99999999999997
109,-65,0.5819594443402982,142,1,71,71,59.999999999999986
110,28,0.5790496471185967,49,1,24,25,59.99999999999999
111,39,0.5761543988830038,38,1,22,16,60.0
112,26,0.5732736268885887,51,1,30,21,60.262683754714345
113,-88,0.5704072587541458,165,1,95,70,60.0
114,22,0.567555222460375,55,1,38,17,60.0
115,25,0.5647174463480732,52,1,27,25,60.0
116,31,0.5618938591163328,46,1,27,19,60.0
117,2,0.5590843898207511,75,1,46,29,60.0
118,46,0.5562889678716474,31,1,17,14,60.84353916434263
119,13,0.5535075230322891,64,1,31,33,60.0
120,46,0.5507399854171277,31,1,14,17,62.74016439942457
121,38,0.547986285490042,39,1,25,14,66.45603152620349
122,23,0.5452463540625918,54,1,29,25,61.85414111932309
123,45,0.5425201222922789,32,1,17,15,65.70034610454931
124,-284,0.5398075216808175,300,0,159,141,60.0
125,-34,0.5371084840724134,111,1,59,52,60.0
126,-76,0.5344229416520513,153,1,78,75,60.0
127,-8,0.531750826943791,85,1,41,44,60.0
128,25,0.5290920728090721,52,1,25,27,60.0
129,35,0.5264466124450268,42,1,22,20,60.659890430726875
130,-73,0.5238143793828016,150,1,78,72,60.0
131,26,0.5211953074858876,51,1,26,25,60.0
132,8,0.5185893309484582,69,1,37,32,60.0
133,44,0.5159963842937159,33,1,17,16,60.0
134,-44,0.5134164023722473,121,1,50,71,60.0
135,31,0.510849320360386,46,1,26,20,60.0
136,36,0.5082950737585841,41,1,20,21,60.0
137,-71,0.5057535983897912,148,1,85,63,60.0
138,-15,0.5032248303978422,92,1,46,46,60.0
139,13,0.500708706245853,64,1,31,33,60.0
140,39,0.4982051627146237,38,1,16,22,60.0
141,38,0.49571413690105054,39,1,24,15,60.0
142,52,0.4932355662165453,25,1,10,15,60.0
143,44,0.4907693883854626,33,1,12,21,60.0
144,-172,0.4883155414435353,249,1,124,125,60.0
145,40,0.4858739637363176,37,1,15,22,60.0
146,44,0.483444593917636,33,1,17,16,60.0
147,21,0.4810273709480478,56,1,27,29,60.0
148,40,0.47862223409330756,37,1,23,14,60.0
149,27,0.47622912292284103,50,1,17,33,60.0
150,55,0.4738479773082268,22,1,6,16,60.0
151,16,0.47147873742168567,61,1,32,29,60.0
152,-73,0.46912134373457726,150,1,76,74,60.0
153,24,0.46677573701590436,53,1,25,28,60.0
154,27,0.46444185833082485,50,1,20,30,60.0
155,-23,0.46211964903917074,100,1,45,55,60.0
156,-15,0.4598090507939749,92,1,47,45,60.0
157,44,0.457510005540005,33,1,14,19,60.0
158,38,0.45522245551230495,39,1,18,21,60.0
159,36,0.4529463432347434,41,1,15,26,60.0
160,54,0.4506816115185697,23,1,8,15,60.0
161,21,0.4484282034609769,56,1,25,31,63.18731874876235
162,23,0.446186062443672,54,1,22,32,60.0
163,23,0.4439551321314536,54,1,24,30,60.0
164,49,0.4417353564707963,28,1,11,17,61.2334297957873
165,-1,0.43952667968844233,78,1,32,46,60.0
166,40,0.43732904629000013,37,1,15,22,60.0
167,36,0.4351424010585501,41,1,17,24,60.24946610773527
168,32,0.43296668905325736,45,1,19,26,60.62879537485827
169,24,0.43080185560799106,53,1,22,31,62.5190730790985
170,24,0.4286478463299511,53,1,24,29,61.19216710704019
171,16,0.42650460709830135,61,1,33,28,60.267916919367636
172,46,0.42437208406280985,31,1,12,19,65.14430749783605
173,39,0.4222502236424958,38,1,16,22,61.13031026625404
174,-9,0.42013897252428334,86,1,40,46,60.0
175,9,0.4180382776616619,68,1,25,43,60.0
176,11,0.4159480862733536,66,1,32,34,60.0
177,30,0.41386834584198684,47,1,25,22,60.125761830785976
178,-55,0.4117990041127769,132,1,54,78,60.0
179,-21,0.40974000909221303,98,1,39,59,60.0
180,-42,0.40769130904675194,119,1,45,74,60.0
181,-60,0.40565285250151817,137,1,57,80,60.0
182,-7,0.4036245882390106,84,1,36,48,60.0
183,40,0.4016064652978155,37,1,16,21,60.0
184,32,0.3995984329713264,45,1,11,34,60.0
185,-38,0.3976004408064698,115,1,41,74,60.0
186,35,0.39561243860243744,42,1,10,32,60.0
187,25,0.3936343764094253,52,1,16,36,60.0
188,15,0.39166620452737816,62,1,26,36,60.0
189,37,0.3897078735047413,40,1,18,22,60.0
190,4,0.3877593341372176,73,1,23,50,60.0
191,-8,0.3858205374665315,85,1,34,51,60.0
192,54,0.38389143477919885,23,1,10,13,60.0
193,43,0.3819719776053028,34,1,12,22,60.0
194,50,0.3800621177172763,27,1,10,17,60.284204279834675
195,53,0.37816180712868996,24,1,8,16,61.22666186526486
196,52,0.37627099809304654,25,1,9,16,61.696300694651825
197,59,0.3743896431025813,18,1,6,12,61.930325127681236
198,-66,0.37251769488706843,143,1,62,81,60.0
199,20,0.3706551064126331,57,1,16,41,60.0
200,44,0.36880183088056995,33,1,14,19,60.0
201,34,0.3669578217261671,43,1,23,20,60.21651086922486
202,21,0.36512303261753626,56,1,22,34,60.0
203,3,0.3632974174544486,74,1,30,44,60.0
204,53,0.3614809303671764,24,1,7,17,60.0
205,-27,0.3596735257153405,104,1,39,65,60.0
206,43,0.3578751580867638,34,1,12,22,60.0
207,54,0.35608578229633,23,1,5,18,60.0
208,40,0.3543053533848483,37,1,11,26,60.24577849426737
209,55,0.35253382661792404,22,1,3,19,61.20426907008586
210,55,0.3507711574848344,22,1,7,15,61.68351434586465
211,52,0.34901730169741024,25,1,6,19,61.92313697768881
212,54,0.3472722151889232,23,1,6,17,62.04294829056828
213,55,0.3455358541129786,22,1,8,14,62.10285394549171
214,56,0.3438081748424137,21,1,6,15,62.132806772195266
215,56,0.3420891339682016,21,1,6,15,62.14778318516797
216,-170,0.3403786882983606,247,1,86,161,60.0
217,41,0.3386767948568688,36,1,10,26,60.0
218,44,0.33698341088258443,33,1,14,19,60.0
219,-8,0.3352984938281715,85,1,29,56,60.0
220,48,0.33362200135903064,29,1,7,22,60.0
221,47,0.33195389135223546,30,1,11,19,60.0
222,56,0.3302941218954743,21,1,6,15,60.24650279292092
223,50,0.32864265128599696,27,1,12,15,61.204631195151904
224,57,0.326999438029567,20,1,6,14,61.683695396267304
225,59,0.3253644408394192,18,1,5,13,61.92322749682496
226,55,0.3237376186352221,22,1,9,13,62.04299354710376
227,45,0.322118930542046,32,1,10,22,60.04099210189699
228,-104,0.32050833588933575,181,1,67,114,60.0
229,28,0.31890579420988907,49,1,12,37,60.0
230,46,0.3173112652388396,31,1,7,24,60.0
231,55,0.3157247089126454,22,1,3,19,60.21188755398167
232,58,0.3141460853680822,19,1,4,15,61.18732357568209
233,55,0.3125753549412418,22,1,7,15,61.6750415865323
234,47,0.31101247816653554,30,1,13,17,61.91890059195741
235,58,0.30945741577570285,19,1,5,14,62.040830094669964
236,52,0.3079101286968243,25,1,4,21,60.00295657051956
237,43,0.3063705780533402,34,1,10,24,60.0
238,39,0.30483872516307353,38,1,15,23,60.0
239,45,0.3033145315372582,32,1,9,23,60.0
240,46,0.3017979588795719,31,1,9,22,60.0
241,48,0.30028896908517405,29,1,11,18,60.0
242,12,0.2987875242397482,65,1,18,47,60.0
243,7,0.29729358661854943,70,1,22,48,60.0
244,20,0.29580711868545667,57,1,17,40,60.0
245,27,0.2943280830920294,50,1,16,34,60.0
246,10,0.29285644267656924,67,1,19,48,60.0
247,38,0.2913921604631864,39,1,12,27,60.0
248,53,0.28993519966087045,24,1,6,18,60.0
249,49,0.2884855236625661,28,1,4,24,60.0
250,50,0.28704309604425327,27,1,7,20,60.27930910556361
251,52,0.285607880564032,25,1,10,15,61.221034351473065
252,61,0.28417984116121187,16,1,3,13,61.69189697442779
253,51,0.2827589419554058,26,1,6,20,61.927328285905155
254,56,0.28134514724562876,21,1,5,16,62.04504394164384
255,57,0.2799384215094006,20,1,6,14,62.10390176951318
256,60,0.27853872940185365,17,1,2,15,62.13333068344785
257,54,0.27714603575484437,23,1,5,18,62.148045140415185
258,60,0.2757603055760701,17,1,5,12,62.15540236889885
259,58,0.2743815040481898,19,1,6,13,62.15908098314068
260,59,0.2730095965279488,18,1,3,15,62.1609202902616
261,58,0.27164454854530906,19,1,3,16,62.16183994382206
262,58,0.2702863258025825,19,1,6,13,62.16229977060229
263,57,0.2689348941735696,20,1,3,17,62.1625296839924
264,55,0.26759021970270175,22,1,7,15,62.16264464068746
265,58,0.2662522686041882,19,1,5,14,62.16270211903499
266,57,0.2649210072611673,20,1,5,15,62.162730858208754
267,58,0.26359640222486147,19,1,7,12,62.16274522779564
268,54,0.26227842021373715,23,1,7,16,62.16275241258908
269,58,0.2609670281126685,19,1,5,14,62.162756004985795
270,59,0.25966219297210513,18,1,3,15,62.162757801184156
271,51,0.2583638820072446,26,1,8,18,62.16275869928334
272,60,0.2570720625972084,17,1,2,15,62.162759148332924
273,58,0.25578670228422234,19,1,4,15,62.16275937285772
274,61,0.25450776877280124,16,1,1,15,62.16275948512012
275,59,0.2532352299289372,18,1,4,14,62.16275954125132
276,42,0.2519690537792925,35,1,9,26,60.541131238287925
277,-174,0.2507092085103961,251,1,57,194,60.0
278,34,0.2494556624678441,43,1,9,34,60.0
279,16,0.24820838415550486,61,1,17,44,60.0
280,49,0.24696734223472733,28,1,4,24,60.25577329790934
281,54,0.2457325055235537,23,1,7,16,61.20926644764593
282,47,0.24450384299593592,30,1,6,24,61.686013022514224
283,51,0.24328132378095624,26,1,8,18,60.0
284,56,0.24206491716205145,21,1,5,16,60.0
285,56,0.2408545925762412,21,1,7,14,61.68039211149153
286,32,0.23965031961336,45,1,13,32,61.93020121549912
287,28,0.2384520680152932,49,1,9,40,60.0
288,-80,0.23725980767521673,157,1,39,118,60.0
289,39,0.23607350863684065,38,1,7,31,60.0
290,45,0.23489314109365644,32,1,10,22,60.0
291,54,0.23371867538818816,23,1,6,17,60.52516045030871
292,57,0.23255008201124722,20,1,5,15,61.37098346439364
293,53,0.231387331601191,24,1,7,17,61.784117007771144
294,55,0.23023039494318503,22,1,5,17,61.9906837794599
295,56,0.2290792429684691,21,1,7,14,62.08009961848971
296,61,0.22793384675362674,16,1,2,14,62.12311857297037
297,56,0.22679417751985861,21,1,4,17,62.14378356769357
298,54,0.22566020663225933,23,1,6,17,62.1536938237966
299,56,0.22453190559909803,21,1,6,15,62.15843783121884
300,61,0.22340924607110255,16,1,1,15,62.16070427461532
301,7,0.22229219984074702,70,1,17,53,60.52244561206912
302,-4,0.2211807388415433,81,1,14,67,60.0
303,36,0.22007483514733558,41,1,12,29,60.0
304,55,0.2189744609715989,22,1,6,16,60.26874901370317
305,45,0.2178795886667409,32,1,9,23,61.21575760430268
306,59,0.2167901907234072,18,1,3,15,61.68926025022252
307,50,0.21570623976979014,27,1,10,17,61.92601074849247
308,61,0.21462770857094118,16,1,1,15,62.04438558528247
309,-74,0.21355457002808648,151,1,27,124,60.0
310,28,0.21248679717794605,49,1,7,42,60.0
311,55,0.21142436319205632,22,1,3,19,60.0
312,45,0.21036724137609603,32,1,6,26,60.21924442127546
313,54,0.20931540516921554,23,1,4,19,61.191002015771886
314,54,0.20826882814336947,23,1,3,20,61.67688080979865
315,54,0.20722748400265262,23,1,7,16,61.919820205201304
316,61,0.20619134658263935,16,1,2,14,62.041289902097276
317,56,0.20516038984972615,21,1,4,17,62.102024750142576
318,59,0.2041345879004775,18,1,2,16,62.132392173963886
319,59,0.2031139149609751,18,1,4,14,62.147575885773875
320,57,0.20209834538617025,20,1,5,15,62.15516774162853
321,55,0.2010878536592394,22,1,9,13,62.15896366953069
322,61,0.2000824143909432,16,1,2,14,62.1608616334629
323,62,0.19908200231898848,15,1,2,13,62.16181061542585
324,59,0.19808659230739353,18,1,3,15,62.162285106405754
325,59,0.19709615934585656,18,1,3,15,62.16252235189492
326,57,0.19611067854912728,20,1,4,16,62.16264097463912
327,59,0.19513012515638165,18,1,3,15,62.16270028601102
328,60,0.19415447453059972,17,1,3,14,62.16272994169687
329,59,0.19318370215794672,18,1,2,16,62.16274476953974
330,57,0.192217783647157,20,1,4,16,62.16275218346115
331,56,0.1912566947289212,21,1,5,16,62.16275589042185
332,60,0.1903004112552766,17,1,5,12,62.16275774390219
333,59,0.18934890919900021,18,1,3,15,62.16275867064236
334,53,0.18840216465300522,24,1,8,16,62.16275913401244
335,60,0.18746015382974018,17,1,3,14,62.16275936569748
336,60,0.1865228530605915,17,1,2,15,62.16275948154
337,56,0.18559023879528855,21,1,4,17,62.16275953946126
338,57,0.1846622876013121,20,1,4,16,62.16275956842189
339,54,0.18373897616330553,23,1,7,16,62.162759582902204
340,58,0.182820281282489,19,1,4,15,62.16275959014236
341,56,0.18190617987607657,21,1,5,16,62.16275959376244
342,60,0.18099664897669618,17,1,2,15,62.16275959557248
343,61,0.1800916657318127,16,1,1,15,62.1627595964775
344,58,0.17919120740315364,19,1,4,15,62.16275959693001
345,58,0.17829525136613786,19,1,5,14,62.16275959715627
346,60,0.17740377510930716,17,1,2,15,62.16275959726939
347,60,0.17651675623376062,17,1,2,15,62.16275959732596
348,57,0.1756341724525918,20,1,3,17,62.16275959735424
349,62,0.17475600159032884,15,1,0,15,62.16275959736838
350,59,0.17388222158237718,18,1,3,15,62.16275959737545
351,56,0.1730128104744653,21,1,4,17,62.16275959737898
352,61,0.17214774642209296,16,1,1,15,62.16275959738075
353,61,0.1712870076899825,16,1,2,14,62.16275959738164
354,62,0.17043057265153258,15,1,0,15,62.16275959738208
355,54,0.16957841978827493,23,1,5,18,62.1627595973823
356,59,0.16873052768933355,18,1,3,15,62.162759597382404
357,60,0.1678868750508869,17,1,3,14,62.16275959738246
358,60,0.16704744067563246,17,1,4,13,62.16275959738249
359,-19,0.1662122034722543,96,1,21,75,60.0
360,-155,0.16538114245489302,232,1,35,197,60.0
361,18,0.16455423674261854,59,1,10,49,60.0
362,21,0.16373146555890544,56,1,14,42,60.0
363,44,0.16291280823111093,33,1,5,28,60.228524770401414
364,46,0.16209824418995536,31,1,5,26,61.19564218389196
365,60,0.16128775296900558,17,1,1,16,61.67920089063724
366,60,0.16048131420416054,17,1,1,16,61.92098024400988
367,58,0.15967890763313974,19,1,4,15,62.0418699206962
368,59,0.15888051309497406,18,1,3,15,62.10231475903936
369,55,0.1580861105294992,22,1,5,17,62.13253717821094
370,61,0.1572956799768517,16,1,1,15,62.14764838779673
371,62,0.15650920157696743,15,1,0,15,62.15520399258962
372,53,0.1557266555690826,24,1,10,14,62.15898179498607
373,61,0.1549480222912372,16,1,2,14,62.16087069618429
374,62,0.15417328217978102,15,1,0,15,62.161815146783404
375,56,0.1534024157688821,21,1,7,14,62.16228737208296
376,57,0.1526354036900377,20,1,4,16,62.16252348473274
377,60,0.1518722266715875,17,1,2,15,62.162641541057624
378,61,0.15111286553822956,16,1,2,14,62.16270056922007
379,60,0.15035730121053842,17,1,2,15,62.1627300833013
380,62,0.14960551470448571,15,1,3,12,62.16274484034191
381,59,0.14885748713096328,18,1,2,16,62.16275221886221
382,61,0.14811319969530845,16,1,1,15,62.162755908122364
383,60,0.1473726336968319,17,1,2,15,62.16275775275244
384,59,0.14663577052834775,18,1,3,15,62.16275867506748
385,57,0.14590259167570602,20,1,3,17,62.162759136225
386,62,0.1451730787173275,15,1,1,14,62.162759366803755
387,62,0.14444721332374086,15,1,0,15,62.162759482093136
388,59,0.14372497725712216,18,1,4,14,62.16275953973783
389,58,0.14300635237083656,19,1,4,15,62.162759568560176
390,60,0.14229132060898236,17,1,2,15,62.16275958297135
391,60,0.14157986400593744,17,1,2,15,62.16275959017693
392,61,0.14087196468590776,16,1,1,15,62.162759593779725
393,59,0.14016760486247823,18,1,3,15,62.16275959558112
394,56,0.13946676683816583,21,1,3,18,62.16275959648182
395,57,0.138769433003975,20,1,6,14,62.16275959693217
396,61,0.13807558583895513,16,1,3,13,62.16275959715735
397,61,0.13738520790976036,16,1,1,15,62.16275959726993
398,61,0.13669828187021155,16,1,3,13,62.16275959732623
399,61,0.13601479046086049,16,1,2,14,62.16275959735437
400,56,0.1353347165085562,21,1,4,17,62.16275959736845
401,59,0.1346580429260134,18,1,4,14,62.162759597375484
402,60,0.13398475271138335,17,1,3,14,62.162759597379
403,57,0.13331482894782642,20,1,5,15,62.162759597380756
404,61,0.13264825480308728,16,1,2,14,62.16275959738164
405,62,0.13198501352907185,15,1,2,13,62.16275959738208
406,60,0.1313250884614265,17,1,2,15,62.1627595973823
407,62,0.13066846301911936,15,1,1,14,62.162759597382404
408,62,0.13001512070402377,15,1,2,13,62.16275959738246
409,61,0.12936504510050365,16,1,1,15,62.16275959738249
410,58,0.12871821987500112,19,1,3,16,62.162759597382504
411,62,0.12807462877562611,15,1,1,14,62.16275959738251
412,60,0.12743425563174798,17,1,1,16,62.16275959738252
413,60,0.12679708435358925,17,1,2,15,62.16275959738252
414,58,0.1261630989318213,19,1,4,15,62.16275959738252
415,56,0.1255322834371622,21,1,4,17,62.16275959738252
416,60,0.12490462201997637,17,1,3,14,62.16275959738252
417,56,0.1242800989098765,21,1,4,17,62.16275959738252
418,62,0.12365869841532712,15,1,0,15,62.16275959738252
419,61,0.12304040492325048,16,1,2,14,62.16275959738252
420,58,0.12242520289863423,19,1,3,16,62.16275959738252
421,61,0.12181307688414106,16,1,1,15,62.16275959738252
422,60,0.12120401149972035,17,1,2,15,62.16275959738252
423,60,0.12059799144222175,17,1,3,14,62.16275959738252
424,59,0.11999500148501063,18,1,2,16,62.16275959738252
425,57,0.11939502647758558,20,1,4,16,62.16275959738252
426,62,0.11879805134519765,15,1,0,15,62.16275959738252
427,-171,0.11820406108847166,248,1,31,217,60.0
428,45,0.1176130407830293,32,1,3,29,60.0
429,44,0.11702497557911415,33,1,2,31,60.0
430,27,0.11643985070121858,50,1,10,40,60.0
431,53,0.11585765144771248,24,1,4,20,60.0
432,47,0.11527836319047392,30,1,6,24,60.0
433,50,0.11470197137452155,27,1,3,24,60.249508291570976
434,56,0.11412846151764894,21,1,4,17,61.20613394447675
435,61,0.1135578192100607,16,1,2,14,61.68444677092963
436,61,0.11299003011401039,16,1,1,15,61.92360318415608
437,62,0.11242507996344034,15,1,1,14,62.0431813907693
438,60,0.11186295456362313,17,1,4,13,62.102970494075905
439,62,0.11130363979080501,15,1,0,15,62.13286504572921
440,61,0.11074712159185099,16,1,1,15,62.14781232155586
441,61,0.11019338598389174,16,1,1,15,62.15528595946919
442,61,0.10964241905397228,16,1,2,14,62.15902277842585
443,59,0.10909420695870241,18,1,4,14,62.160891187904184
444,62,0.1085487359239089,15,1,0,15,62.16182539264335
445,61,0.10800599224428936,16,1,1,15,62.162292495012935
446,62,0.10746596228306791,15,1,0,15,62.162526046197726
447,62,0.10692863247165257,15,1,0,15,62.16264282179012
448,61,0.1063939893092943,16,1,2,14,62.16270120958632
449,59,0.10586201936274783,18,1,3,15,62.16273040348442
450,62,0.10533270926593409,15,1,0,15,62.16274500043347
451,60,0.10480604571960442,17,1,1,16,62.16275229890799
452,62,0.1042820154910064,15,1,0,15,62.162755948145254
453,58,0.10376060541355137,19,1,2,17,62.16275777276388
454,62,0.1032418023864836,15,1,0,15,62.1627586850732
455,56,0.10272559337455119,21,1,3,18,62.16275914122786
456,62,0.10221196540767843,15,1,0,15,62.16275936930519
457,60,0.10170090558064004,17,1,1,16,62.162759483343855
458,61,0.10119240105273684,16,1,1,15,62.16275954036318
459,61,0.10068643904747315,16,1,3,13,62.16275956887285
460,60,0.10018300685223579,17,1,2,15,62.16275958312768
461,61,0.0996820918179746,16,1,1,15,62.1627595902551
462,60,0.0996820918179746,17,1,2,15,62.162759593818805
463,60,0.0996820918179746,17,1,1,16,62.16275959560066
464,52,0.0996820918179746,25,1,5,20,62.16275959649159
465,62,0.0996820918179746,15,1,1,14,62.16275959693705
466,62,0.0996820918179746,15,1,0,15,62.162759597159784
467,62,0.0996820918179746,15,1,0,15,62.16275959727115
468,62,0.0996820918179746,15,1,1,14,62.16275959732683
469,55,0.0996820918179746,22,1,3,19,62.16275959735468
470,60,0.0996820918179746,17,1,4,13,62.1627595973686
471,60,0.0996820918179746,17,1,2,15,62.162759597375555
472,59,0.0996820918179746,18,1,2,16,62.162759597379036
473,61,0.0996820918179746,16,1,1,15,62.16275959738078
474,62,0.0996820918179746,15,1,0,15,62.16275959738165
475,62,0.0996820918179746,15,1,0,15,62.162759597382085
476,62,0.0996820918179746,15,1,1,14,62.162759597382305
477,61,0.0996820918179746,16,1,1,15,62.16275959738241
478,59,0.0996820918179746,18,1,3,15,62.16275959738246
479,60,0.0996820918179746,17,1,2,15,62.16275959738249
480,59,0.0996820918179746,18,1,5,13,62.162759597382504
481,58,0.0996820918179746,19,1,3,16,62.16275959738251
482,60,0.0996820918179746,17,1,2,15,62.16275959738252
483,60,0.0996820918179746,17,1,1,16,62.16275959738252
484,59,0.0996820918179746,18,1,2,16,62.16275959738252
485,62,0.0996820918179746,15,1,0,15,62.16275959738252
486,60,0.0996820918179746,17,1,1,16,62.16275959738252
487,62,0.0996820918179746,15,1,0,15,62.16275959738252
488,61,0.0996820918179746,16,1,2,14,62.16275959738252
489,59,0.0996820918179746,18,1,2,16,62.16275959738252
490,62,0.0996820918179746,15,1,0,15,62.16275959738252
491,62,0.0996820918179746,15,1,0,15,62.16275959738252
492,60,0.0996820918179746,17,1,3,14,62.16275959738252
493,60,0.0996820918179746,17,1,2,15,62.16275959738252
494,57,0.0996820918179746,20,1,4,16,62.16275959738252
495,62,0.0996820918179746,15,1,0,15,62.16275959738252
496,62,0.0996820918179746,15,1,0,15,62.16275959738252
497,57,0.0996820918179746,20,1,6,14,62.16275959738252
498,58,0.0996820918179746,19,1,3,16,62.16275959738252
499,62,0.0996820918179746,15,1,0,15,62.16275959738252
500,61,0.0996820918179746,16,1,1,15,62.16275959738252
